
SO              textures/S.xpm
WE              textures/W.xpm
EA            textures/E.xpm
NO       textures/N.xpm
NO

C 30,30,30
F 105,90,70

        1111111111111111111111111
111111111011000001110011100000001
100000000011000000000000100011111
11110111111111011100000010001111111111111111111111
11110111000111011101010010001000000000000000000001
1111011100011101110101001000000000111111111111111
111100000000000000000000000000010010001      1
11111111 1111111 11111111111111111111111111111
