SO       textures/south.xpm
WES       textures/west.xpm
EA       textures/east.xpm
NO       textures/north.xpm
SO


C 		64,	76,81
F	 30,  30 ,		30


111111111    11111
10000W001 11111
1111111111 111
