Testing\

SO        Textures\

1111