SO       textures/south.xpm
WE       textures/west.xpm


EA       textures/east.xpm
NO       textures/north.xpm
SO

C 		64,	76, 66
F	 30,  30 ,		66


111111111    11111
10000W001 11111
1111111111 111
